严老爷 -> Yan Laoye
丰儿 -> Feng Er
乌进孝 -> Wu Jinxiao
云儿 -> Yun Er
云光 -> Yun Guang
伴鹤 -> Ban He
住儿 -> Zhu Er
余信 -> Yu Xin
余信家的 -> Yu Xinjiade
佩凤 -> Pei Feng
佳蕙 -> Jia Hui
侯孝康 -> Hou Xiaokang
侯晓明 -> Hou Xiaoming
俞禄 -> Yu Lu
倪二 -> Ni Er
偕鸾 -> Xie Luan
傅秋芳 -> Fu Qiufang
傅试 -> Fu Shi
傻大姐 -> Sha Dajie
入画 -> Ru Hua
兴儿 -> Xing Er
冯唐 -> Feng Tang
冯渊 -> Feng Yuan
冯紫英 -> Feng Ziying
冷子兴 -> Leng Zixing
净虚 -> Jing Xu
刘姥姥 -> Liu Laolao
刘氏 -> Liu Shi
单大娘 -> Shan Daniang
单大良 -> Shan Daliang
单聘仁 -> Shan Pinren
卜世仁 -> Bu Shiren
卜固修 -> Bu Guxiu
卫若兰 -> Wei Ruolan
双寿 -> Shuang Shou
双瑞 -> Shuang Rui
史太君 -> Shi Taijun
史湘云 -> Shi Xiangyun
史鼎 -> Shi Ding
史鼐 -> Shi Nai
叶妈 -> Ye Ma
司棋 -> Si Qi
同喜 -> Tong Xi
同贵 -> Tong Gui
吴新登 -> Wu Xindeng
吴贵妃 -> Wu Guifei
周太监 -> Zhou Taijian
周奶娘 -> Zhou Nainiang
周姨娘 -> Zhou Yiniang
周氏 -> Zhou Shi
周瑞 -> Zhou Rui
周瑞家的 -> Zhou Ruijiade
善姐 -> Shan Jie
喜儿 -> Xi Er
喜鸾 -> Xi Luan
四儿 -> Si Er
四姐 -> Si Jie
坠儿 -> Zhui Er
墨雨 -> Mo Yu
夏奶奶 -> Xia Nainai
夏婆子 -> Xia Pozi
夏守忠 -> Xia Shouzhong
夏金桂 -> Xia Jingui
多姑娘 -> Duo Guniang
多官 -> Duo Guan
天文生 -> Tian Wensheng
女先儿 -> Nv Xianer
妙玉 -> Miao Yu
娄氏 -> Lou Shi
媚人 -> Mei Ren
嫣红 -> Yan Hong
孙绍祖 -> Sun Shaozu
宋嬷嬷 -> Song Mama
宝官 -> Bao Guan
宝珠 -> Bao Zhu
宝蟾 -> Bao Chan
寿儿 -> Shou Er
封氏 -> Feng Shi
封肃 -> Feng Su
小吉祥儿 -> Xiao Jixianger
小红 -> Xiao Hong
小舍儿 -> Xiao Sheer
小螺 -> Xiao Luo
小霞 -> Xiao Xia
小鸠儿 -> Xiao Jiuer
小鹊 -> Xiao Que
尤三姐 -> You Sanjie
尤二姐 -> You Erjie
尤氏 -> You Shi
尤老娘 -> You Laoniang
山子野 -> Shan Ziye
平儿 -> Ping Er
庆儿 -> Qing Er
度恨菩提 -> Du Henputi
引愁金女 -> Yin Choujinnv
引泉 -> Yin Quan
张华 -> Zhang Hua
张妈 -> Zhang Ma
张材家的 -> Zhang Caijiade
张若锦 -> Zhang Ruojin
张道士 -> Zhang Daoshi
彩云 -> Cai Yun
彩屏 -> Cai Ping
彩缤 -> Cai Bin
彩霞 -> Cai Xia
待书 -> Dai Shu
戚建辉 -> Qi Jianhui
戴权 -> Dai Quan
戴良 -> Dai Liang
扫花 -> Sao Hua
抱琴 -> Bao Qin
拐子 -> Guai Zi
文官 -> Wen Guan
文杏 -> Wen Xing
文花 -> Wen Hua
方椿 -> Fang Chun
春燕 -> Chun Yan
春纤 -> Chun Xian
昭儿 -> Zhao Er
昭容 -> Zhao Rong
晴雯 -> Qing Wen
智善 -> Zhi Shan
智能 -> Zhi Neng
智通 -> Zhi Tong
朱大娘 -> Zhu Daniang
李公子 -> Li Gongzi
李婶娘 -> Li Shenniang
李嬷嬷 -> Li Mama
李守中 -> Li Shouzhong
李纨 -> Li Wan
李纹 -> Li Wen
李绮 -> Li Qi
李贵 -> Li Gui
杏奴 -> Xing Nu
来喜家的 -> Lai Xijiade
来旺 -> Lai Wang
板儿 -> Ban Er
林之孝 -> Lin Zhixiao
林之孝家的 -> Lin Zhixiaojiade
林如海 -> Lin Ruhai
林黛玉 -> Lin Daiyu
柳五儿 -> Liu Wuer
柳家的 -> Liu Jiade
柳彪 -> Liu Biao
柳湘莲 -> Liu Xianglian
柳芳 -> Liu Fang
梅翰林 -> Mei Hanlin
檀云 -> Tan Yun
水溶 -> Shui Rong
渺渺真人 -> Miao Miaozhenren
潘又安 -> Pan Youan
炒豆儿 -> Chao Douer
焦大 -> Jiao Da
牛清 -> Niu Qing
牛继宗 -> Niu Jizong
玉官 -> Yu Guan
玉钏 -> Yu Chuan
王一贴 -> Wang Yitie
王仁 -> Wang Ren
王信 -> Wang Xin
王君效 -> Wang Junxiao
王善保家的 -> Wang Shanbaojiade
王夫人 -> Wang Furen
王嬷嬷 -> Wang Mama
王子胜 -> Wang Zisheng
王子腾 -> Wang Ziteng
王成 -> Wang Cheng
王济仁 -> Wang Jiren
王熙凤 -> Wang Xifeng
王短腿 -> Wang Duantui
王荣 -> Wang Rong
玻璃 -> Bo Li
珍珠 -> Zhen Zhu
琥珀 -> Hu Po
瑞珠 -> Rui Zhu
甄士隐 -> Zhen Shiyin
甄宝玉 -> Zhen Baoyu
田妈 -> Tian Ma
痴梦仙姑 -> Chi Mengxiangu
石光珠 -> Shi Guangzhu
祝妈 -> Zhu Ma
神瑛侍者 -> Shen Yingshizhe
秋桐 -> Qiu Tong
秋纹 -> Qiu Wen
秦业 -> Qin Ye
秦可卿 -> Qin Keqing
秦显家的 -> Qin Xianjiade
秦钟 -> Qin Zhong
程日兴 -> Cheng Rixing
空空道人 -> Kong Kongdaoren
篆儿 -> Zhuan Er
素云 -> Su Yun
紫鹃 -> Zi Juan
绛珠仙子 -> Jiang Zhuxianzi
绣凤 -> Xiu Feng
绣鸾 -> Xiu Luan
绮霰 -> Qi San
翠云 -> Cui Yun
翠墨 -> Cui Mo
翠缕 -> Cui Lv
翡翠 -> Fei Cui
胡君荣 -> Hu Junrong
胡斯来 -> Hu Silai
胡氏 -> Hu Shi
胡老爷 -> Hu Laoye
臻儿 -> Zhen Er
良儿 -> Liang Er
艾官 -> Ai Guan
花自芳 -> Hua Zifang
芳官 -> Fang Guan
茄官 -> Jia Guan
茗烟 -> Ming Yan
茗玉 -> Ming Yu
茜雪 -> Qian Xue
茫茫大士 -> Mang Mangdashi
莲花儿 -> Lian Huaer
莺儿 -> Ying Er
葵官 -> Kui Guan
蒋子宁 -> Jiang Zining
蒋玉菡 -> Jiang Yuhan
蕊官 -> Rui Guan
薛姨妈 -> Xue Yima
薛宝琴 -> Xue Baoqin
薛宝钗 -> Xue Baochai
薛蝌 -> Xue Ke
薛蟠 -> Xue Pan
藕官 -> Ou Guan
蝉姐 -> Chan Jie
袭人 -> Xi Ren
裘良 -> Qiu Liang
詹光 -> Zhan Guang
警幻仙子 -> Jing Huanxianzi
谢鲸 -> Xie Jing
豆官 -> Dou Guan
贾代儒 -> Jia Dairu
贾代化 -> Jia Daihua
贾代善 -> Jia Daishan
贾元春 -> Jia Yuanchun
贾兰 -> Jia Lan
贾宝玉 -> Jia Baoyu
贾巧姐 -> Jia Qiaojie
贾惜春 -> Jia Xichun
贾探春 -> Jia Tanchun
贾政 -> Jia Zheng
贾效 -> Jia Xiao
贾敏 -> Jia Min
贾敕 -> Jia Chi
贾敦 -> Jia Dun
贾敬 -> Jia Jing
贾敷 -> Jia Fu
贾源 -> Jia Yuan
贾演 -> Jia Yan
贾环 -> Jia Huan
贾珍 -> Jia Zhen
贾珠 -> Jia Zhu
贾珩 -> Jia Hang
贾琏 -> Jia Lian
贾琛 -> Jia Chen
贾琮 -> Jia Cong
贾琼 -> Jia Qiong
贾瑞 -> Jia Rui
贾璜 -> Jia Huang
贾芝 -> Jia Zhi
贾芬 -> Jia Fen
贾芳 -> Jia Fang
贾芷 -> Jia Zhi
贾芸 -> Jia Yun
贾芹 -> Jia Qin
贾荇 -> Jia Xing
贾菌 -> Jia Jun
贾菖 -> Jia Chang
贾菱 -> Jia Ling
贾萍 -> Jia Ping
贾蓁 -> Jia Zhen
贾蓉 -> Jia Rong
贾蓉之妻 -> Jia Rongzhiqi
贾蔷 -> Jia Qiang
贾藻 -> Jia Zao
贾蘅 -> Jia Heng
贾赦 -> Jia She
贾迎春 -> Jia Yingchun
贾雨村 -> Jia Yucun
赖二 -> Lai Er
赖大 -> Lai Da
赖大的母亲 -> Lai Dademuqin
赖尚荣 -> Lai Shangrong
赵亦华 -> Zhao Yihua
赵国基 -> Zhao Guoji
赵姨娘 -> Zhao Yiniang
赵嬷嬷 -> Zhao Mama
邢夫人 -> Xing Furen
邢岫烟 -> Xing Xiuyan
邢德全 -> Xing Dequan
邢忠 -> Xing Zhong
金哥 -> Jin Ge
金彩 -> Jin Cai
金文翔 -> Jin Wenxiang
金氏 -> Jin Shi
金钏 -> Jin Chuan
钱华 -> Qian Hua
钱启 -> Qian Qi
钱槐 -> Qian Huai
银姐 -> Yin Jie
银蝶 -> Yin Die
锄药 -> Chu Yao
陈也俊 -> Chen Yejun
陈瑞文 -> Chen Ruiwen
陈翼 -> Chen Yi
隆儿 -> Long Er
雪雁 -> Xue Yan
霍启 -> Huo Qi
青儿 -> Qing Er
靛儿 -> Dian Er
顽石 -> Wan Shi
香菱 -> Xiang Ling
马尚 -> Ma Shang
马道婆 -> Ma Daopo
马魁 -> Ma Kui
鲍二家的 -> Bao Erjiade
鲍太医 -> Bao Taiyi
鸳鸯 -> Yuan Yang
鹦鹉 -> Ying Wu
麝月 -> She Yue
龄官 -> Ling Guan
