贾演	宁国公，贾源胞兄	第二回	也作“贾寅”
贾源	荣国公，贾宝玉的曾祖父	第二回	也作“贾法”
贾代化	京营节度使世袭一等神威将军。贾演长子。	第二回
贾代善	贾源长子，贾宝玉的祖父	第二回
贾代儒	贾家塾中司塾，贾瑞的祖父	第八回
贾代修	贾府“代”字辈宗族远亲	第十三回
贾敷	贾代化长子，贾敬之兄。早夭	第二回
贾敬	贾代化次子，丙辰科进士，一味好道	第二回	子贾珍、女贾惜春
贾赦	字恩侯，贾代善与贾母的长子，袭荣国公世职	第二回	妻邢夫人、妾嫣红、翠云
贾政	字存周，工部员外郎，贾代善与贾母的次子	第二回	妻王夫人、妾赵、周姨娘
贾敏	贾代善与贾母之女，嫁林如海为妻，林黛玉的生母	第二回
贾敕	贾府远房宗族	第十三回
贾效	贾府远房宗族	第十三回
贾敦	贾府远房宗族	第十三回
贾珍	贾敬之子，贾府族长、世袭三品爵威烈将军	第二回	妻尤氏、妾佩凤、偕鸾、文花、子贾蓉
贾琏	贾赦之子，担任同知的官位	第二回	妻王熙凤、妾尤二姐、秋桐、平儿、女巧姐
贾琮	贾赦之子，庶出	第十三回
贾珠	贾政长子，早夭	第二回	妻李纨、子贾兰
贾宝玉	贾政次子	第二回
贾环	贾政三子，庶出	第十八回
贾瑞	字天祥，贾代儒之孙，生父母未知	第十一回
贾璜	金氏之夫	第十回
贾珩	贾府远房宗族	第十三回
贾㻞	贾府远房宗族	第十三回
贾珖	贾府远房宗族	第十三回
贾琛	贾府远房宗族	第十三回
贾琼	贾府远房宗族	第十三回
贾璘	贾府远房宗族	第十三回
贾元春	贾政长女，皇宫中的贤德妃	第二回	宝玉同胞姐姐
贾迎春	贾赦之女，贾赦前妻所出	第二回	另有本称庶出
贾探春	贾政次女，庶出	第三回	赵姨娘之女，宝玉庶出妹妹，贾环同胞姐弟
贾惜春	贾敬之女，贾珍之胞妹	第三回	四春中年龄最小
喜鸾	贾㻞的妹妹，贾府远方亲族	第七十一回
四姐	贾琼的妹妹，贾府远方亲族	第七十一回
贾蓉	贾珍之子，原为监生，后来担任五品龙禁尉	第六回	妻秦可卿、胡氏（许氏）
贾兰	贾珠与李纨之子	第四回	
贾蔷	宁府的正派玄孙	第四回	
贾菌	娄氏之子	第九回	
贾芸	五嫂子的儿子，被贾宝玉认作干儿子	第十三回	
贾芹	周氏之子，铁槛寺和尚道士的总管	第十三回	
贾萍	贾府远房宗族	第十三回	
贾菖	贾府远房宗族	第十三回	
贾菱	贾府远房宗族	第十三回	
贾蓁	贾府远房宗族	第十三回	
贾藻	贾府远房宗族	第十三回	
贾蘅	贾府远房宗族	第十三回	
贾芬	贾府远房宗族	第十三回	
贾芳	贾府远房宗族	第十三回	
贾芝	贾府远房宗族	第十三回	
贾荇	贾府远房宗族	第五十三回	
贾芷	贾府远房宗族	第五十三回	
贾葛		第五十三回	梦觉、甲辰、列藏三本作“贾菖”，俗写中“曷”常写作“昌”。
贾巧姐	贾琏、王熙凤之女	第二十二回
史太君	贾代善之妻	第二回	李煦
史鼐	保龄侯尚书令史公之后	第二十五回
史鼎	保龄侯尚书令之后，忠靖侯；史鼐之弟	第十三回
史湘云	史鼐、史鼎之侄女	第二十回
王子腾	都太尉统制县伯之后，金陵节度使	第三回
王子胜	都太尉统制县伯之后，王子腾之弟	第三回
王夫人	王子腾之妹，贾政之妻	第三回
薛姨妈	王夫人之妹	第四回	子薛蟠、女薛宝钗
王仁	王熙凤之兄	第十四回
王熙凤	贾琏之妻	第二回
薛蟠	字文起，薛姨妈之子	第四回
薛蝌	皇商之子，薛姨妈之侄	第四十九回	据考，名为“薛虬”
薛宝钗	薛姨妈之女	第四回
薛宝琴	薛蝌之妹	第四十九回
林黛玉	林如海与贾敏之女	第二回
妙玉	尼姑，居于大观园中栊翠庵	第四十一回
邢夫人	贾赦之妻，续娶，非贾琏生母	第三回
尤氏	贾珍之妻，续娶，非贾蓉生母	第十回
李纨	贾珠之妻	第二回
秦可卿	贾蓉之妻	第五回
贾蓉之妻	该人物是一个谜	第二十九回	可能是续娶，也可能是作者在修改过程中出现的错误设定
胡氏	贾蓉续娶之妻	第二十九回	《梦稿本》，其他版本无胡氏
许氏	贾蓉续娶之妻	第五十八回	见《庚辰本》、《甲辰本》、《列藏本》和《梦稿本》
香菱	甄士隐之女，本名甄英莲，后为薛蟠之妾	第一回
赵姨娘	贾政之妾，探春、贾环之母	第十八回
刘姥姥	王夫人父亲的连宗宗侄孙王成之子狗儿的岳母	第六回
甄宝玉	甄家公子	第二回
袭人	本名“珍珠”，原为贾母的丫鬟，后送与贾宝玉	第三回	脂本第二十九回，贾母身边又曾出现一名唤“珍珠”的丫鬟
媚人	贾宝玉的丫鬟	第五回	庚辰本第五回中有此人物，但自此之后消失不见；程甲本中改作“秋纹”。
晴雯	贾宝玉的丫鬟，同样由贾母送与贾宝玉	第五回
绮霰	贾宝玉的丫鬟	第二十回	也作“绮霞”
麝月	贾宝玉的丫鬟	第五回
檀云	贾宝玉的丫鬟	第二十四回	张爱玲认为檀云就是晴雯
秋纹	贾宝玉的丫鬟	第十九回
碧浪	贾宝玉的丫鬟	第二十回	有的版本也作“碧痕”
茜雪	贾宝玉的丫鬟，后被贾宝玉撵出	第八回
春燕	贾宝玉的丫鬟，也叫“小燕”	第五十五回
坠儿	贾宝玉的丫鬟	第二十六回
四儿	贾宝玉的丫鬟，原名蕙香	第二十一回
佳蕙	贾宝玉的小丫鬟	第二十五回
抱琴	贾元春的丫鬟	第十八回
司棋	贾迎春的丫鬟	第七回
莲花儿	贾迎春的丫鬟	第二十九回
绣橘	贾迎春的丫鬟	第二十九回
待书	贾探春的丫鬟	第七回	也作“侍书”
翠墨	贾探春的丫鬟	第二十九回
蝉姐	贾探春的丫鬟	第六十回
入画	贾惜春的丫鬟	第七回
彩屏	贾惜春的丫鬟	第二十九回
紫鹃	原为贾母的丫鬟，名为“鹦哥”，后送与林黛玉	第三回
雪雁	林黛玉的小丫鬟，从老家带来	第三回
春纤	林黛玉的丫鬟	第二十九回
鸳鸯	贾母的丫鬟	第二十回
琥珀	贾母的丫鬟	第二十九回
珍珠	贾母的丫鬟	第五十九回
玻璃	贾母的丫鬟	第五十九回
翡翠	贾母的丫鬟	第五十九回
鹦鹉	贾母的丫鬟	第二十九回
靛儿	贾母的丫鬟	第三十回
傻大姐	贾母的丫头	第七十三回
银蝶	尤氏的丫鬟	第七十五回
炒豆儿	尤氏的丫鬟	第七十五回
万儿	贾珍和尤氏的丫鬟	第十九回
莺儿	薛宝钗的丫鬟	第七回
文杏	薛宝钗的丫鬟	第二十九回
平儿	王熙凤的通房大丫鬟	第六回
小红	原名林红玉，先为贾宝玉的丫鬟，后被王熙凤要去	第二十三回
丰儿	王熙凤的丫鬟	第六回
金钏	王夫人的丫鬟，因不堪受辱，跳井而死	第七回
玉钏	王夫人的丫鬟，金钏之胞妹	第二十五回
绣鸾	王夫人的丫鬟	第二十三回
绣凤	王夫人的丫鬟	第二十三回
彩云	王夫人的丫鬟	第二十三回
彩霞	王夫人的丫鬟	第二十三回
素云	李纨的丫头	第二十九回
同喜	薛姨妈的丫头	第二十九回
同贵	薛姨妈的丫头	第二十九回
缕儿	史湘云的丫鬟	第三十一回
翠缕	史湘云的丫鬟	第三十回
宝珠	秦可卿的丫鬟，秦可卿死后，自认为其义女	第十三回
瑞珠	秦可卿的丫鬟，秦可卿死后，触柱而亡	第十三回
姣杏	甄士隐家的丫鬟，后被送与贾雨村	第一回
小螺	薛宝琴的丫鬟	第五十回
善姐	原来为王熙凤的丫鬟，后送与尤二姐	第六十八回
臻儿	香菱的丫鬟	第二十九回
篆儿	邢岫烟的丫鬟	第五十七回	第五十二回也有一个同名的叫篆儿，是贾宝玉的小丫环。但有的版本却是叫定儿。
小吉祥儿	赵姨娘的丫鬟	第五十七回
小鹊	赵姨娘的丫鬟	第七十三回
小舍儿	夏金桂的丫鬟	第八十回
宝蟾	夏金桂的陪房丫头	第八十回
茗烟	贾宝玉的小厮	第九回	有的回目也作“焙茗”
焦大	宁国府里从小跟随宁国公的老仆人	第七回
李贵	宝玉的奶兄、仆人，李嬷嬷之子	第九回
锄药	贾宝玉的小厮	第九回
墨雨	贾宝玉的小厮	第九回
伴鹤	贾宝玉的小厮	第二十四回
扫花	贾宝玉的小厮	第二十四回
引泉	贾宝玉的小厮	第二十四回
挑芸	贾宝玉的小厮	第二十四回
双瑞	贾宝玉的小厮	第二十八回
双寿	贾宝玉的小厮	第二十八回
来旺	贾琏、王熙凤的仆人	第十五回
兴儿	贾珍的小厮	第五十三回
王荣	贾宝玉的仆人	第五十一回
钱启	贾宝玉的仆人	第五十一回
张若锦	贾宝玉的仆人	第五十一回
赵亦华	贾宝玉的仆人	第五十一回
钱槐	贾环的小厮，赵姨娘的内侄	第六十回
小玄儿	贾府角门看门的小厮	第六十回
隆儿	贾琏的小厮	第六十五回
昭儿	贾琏、王熙凤的小厮	第十四回
喜儿	贾珍的小厮	第六十五回
住儿
寿儿	贾珍的小厮	第六十五回
杏奴	柳湘莲的小厮	第四十七回
庆儿	贾琏、王熙凤的小厮	第六十八回
王信	贾琏、王熙凤的小厮	第六十八回
芳官	十二官之一，扮正旦	第五十八回	服侍贾宝玉，被改名为耶律雄奴、温都里纳。后王夫人“赏”她跟水月庵的智通出家。
龄官	十二官之一，扮小旦	第十八回	与贾蔷相好，曾蹲在蔷薇花下不停的写着‘蔷’字，使得宝玉看的惊讶又感叹。戏班解散后，离开贾府，便无下落。
蕊官	十二官之一，扮小旦	第五十八回	服侍薛宝钗，与藕官恩爱。最后同藕官同到地藏庵出家。
藕官	十二官之一，扮小生	第五十八回	服侍林黛玉，原与菂官恩爱，菂官死后还在大观园烧纸钱而祭。之后又与蕊官恩爱，最后同蕊官同到地藏庵出家。
豆官	十二官之一，扮小花脸	第五十八回	服侍薛宝琴。
宝官	十二官之一，扮小生	第三十回
文官	十二官之一，扮小生	第三十回	服侍贾母。
茄官	十二官之一，扮老旦	第五十八回	服侍尤氏。
菂官	十二官之一，扮小旦	第五十八回	藕官之同性爱人。离去后死亡。
艾官	十二官之一，扮老外	第五十八回	服侍贾探春。
玉官	十二官之一，扮小旦	第三十回
葵官	十二官之一，扮大花脸	第五十八回	服侍史湘云。
顽石	女娲补天所剩，被茫茫大士、渺渺真人幻变化成美玉	第一回
茫茫大士	将顽石变成美玉的僧人，即后回书中的癞头僧人	第一回
渺渺真人	将顽石变成美玉的道人，即后回书中的跛足道人	第一回
空空道人	抄录《石头记》的道人，后易名为情僧	第一回
甄士隐	名费，字士隐，姑苏（苏州）人士	第一回
封氏	甄士隐之妻	第一回
神瑛侍者	神仙，贾宝玉的前身	第一回	关于神瑛侍者，也有说是甄（真）宝玉前身，而非贾（假）宝玉的说法[2]。
绛珠仙子	神仙，受神瑛侍者甘露之恩，林黛玉的前身	第一回
警幻仙子	太虚幻境的仙姑	第一回
贾雨村	名化，字时飞，别号雨村，曾作过黛玉的老师	第一回
严老爷	甄士隐的朋友，前任官吏	第一回
霍启	甄士隐家的奴仆	第一回
封肃	甄士隐的岳父，小地主	第二回
冷子兴	周瑞的女婿，都中古董商	第二回
林如海	名海，林黛玉之父，巡盐御史	第二回
李嬷嬷	宝玉的奶娘，李贵之母	第三回
王嬷嬷	黛玉自幼的奶娘	第三回
门子	葫芦庙的小和尚，应天府差役	第四回
李守中	李纨之父，任国子监	第四回
冯渊	小乡绅之子，被薛蟠打死	第四回
拐子	拐卖英莲的人贩子	第四回
痴梦仙姑	太虚幻境的仙姑	第五回
引愁金女	太虚幻境的仙姑	第五回
种情大士	太虚幻境的仙姑	第五回
度恨菩提	太虚幻境的仙姑	第五回
王成	狗儿之父，其父与王夫人的父亲联宗	第六回
刘氏	狗儿之妻，刘姥姥的女儿	第六回
板儿	狗儿、刘氏之子	第六回
青儿	狗儿、刘氏之女	第六回
周瑞	王夫人的陪房，贾府掌管收取地租的管家	第六回
周瑞家的	周瑞之妻，王夫人的陪房，冷子兴的岳母	第六回
智能	水月庵的尼姑，也称“能儿”或“智能儿”	第七回
余信	贾府掌管寺庙月例银子的管家	第七回
余信家的	余信之妻	第七回
秦钟	字鲸卿，秦业之子，秦可卿之弟	第七回
赖二	又名赖升，宁府总管家	第七回
詹光	字子亮，贾政的清客相公，善工笔画	第八回
戴良	管粮仓的头目	第八回
钱华	贾府的买办	第八回
单聘仁	贾政的清客相公	第八回
吴新登	荣国府银库房总管	第八回
秦业	秦可卿的养父，秦钟的父亲，任营缮郎	第八回
胡氏	金荣之母	第十回
金氏	金荣的姑妈，贾璜之妻，也称璜大奶奶、贾璜家的	第十回
冯唐	神武将军	第十回
张友士	冯紫英的老师，懂医术	第十回
戴权	大明宫掌宫内相	第十三回
张材家的	张材之妻	第十三回
牛清	镇国公	第十四回
牛继宗	牛清的孙子，世袭一等伯	第十四回
柳彪	理国公	第十四回
柳芳	柳彪的孙子，世袭一等子	第十四回
陈翼	齐国公	第十四回
陈瑞文	陈翼的孙子，世袭三品威镇将军	第十四回
马魁	治国公	第十四回
马尚	马魁的孙子，世袭三品威远将军	第十四回
侯晓明	修国公	第十四回
侯孝康	侯晓明的孙子，世袭一等子	第十四回
石光珠	缮国公的孙子	第十四回
蒋子宁	平原侯之孙，世袭二等男	第十四回
谢鲸	定城侯之孙，世袭二等男	第十四回
戚建辉	襄阳侯之孙，世袭二等男	第十四回
裘良	景田侯子、之孙，王城兵马司	第十四回
冯紫英	神武将军冯唐之子	第十四回
陈也俊		第十四回
卫若兰		第十四回
水溶	北静郡王	第十四回
净虚	水月庵的老尼姑，智能、智善的师傅	第十五回
智善	水月庵尼姑	第十五回
胡老爷	曾任京畿道，贾蓉的续妻胡氏之父	第十五回
金哥	长安县大财主张姓的女儿	第十五回
李公子	长安府府太爷的小舅子，也称李衙内、李少爷	第十五回
云光	长安节度使	第十五回
夏守忠	六宫都太监	第十六回
赖大	荣国府大管家，赖尚荣之父	第十六回
赵嬷嬷	贾琏的奶妈，赵天梁、赵天栋之母	第十六回
吴天佑	吴贵妃之父	第十六回
吴贵妃	皇宫中的贵妃	第十六回
卜固修	贾政的清客相公	第十六回
山子野	设计大观园的园艺师	第十六回
林之孝	荣国府二管家，收管各处房田事务，小红的父亲	第十六回
程日兴	贾政的清客相公，古董行老板，善画美人	第十六回
昭容	宫中女官	第十八回
彩缤	宫中女官	第十八回
花母	袭人的母亲	第十九回
花自芳	袭人之兄	第十九回
多官	荣国府的酒头厨子，绰号“多浑虫”	第二十一回
多姑娘	也称灯姑娘，多浑虫之妻	第二十一回
王嫂子	贾芸之母	第二十三回
周氏	贾芹之母	第二十三回
卜世仁	贾芸的舅舅，香料铺的掌柜	第二十四回
银姐	卜世仁之女	第二十四回
倪二	贾芸的邻居，也称老二	第二十四回
王短腿	马贩子	第二十四回
林之孝家的	林之孝之妻，贾府中总领家事的媳妇	第二十四回
方椿	花匠	第二十四回
马道婆	贾宝玉寄名的干娘	第二十五回
周姨娘	贾政之妾	第二十五回
胡斯来	贾政的清客相公	第二十六回
鲍太医	太医	第二十八回
王济仁	太医。也称王大夫、王太医	第二十八回
蒋玉菡	贵顺亲王府的戏子，饰小旦	第二十八回
云儿	锦香院的妓女	第二十八回
张道士	清虚观道士，任道录司长官	第二十九回
周奶娘	史湘云的奶妈	第三十一回
傅试	贾政的门生，官任通判	第三十五回
傅秋芳	傅试的妹妹	第三十五回
宋嬷嬷	也称宋妈	第三十七回
茗玉	刘姥姥所编的故事中的人物	第三十九回
王君效	王济仁的师祖	第四十二回
赖大的母亲	赖大、赖二的母亲	第四十三回
鲍二家的	鲍二的妻子	第四十五回
金彩	鸳鸯之父	第四十六回
金文翔	鸳鸯的哥哥，贾母的买办	第四十六回
嫣红	贾赦妾	第四十七回
柳湘莲	绰号“冷郎君”，世家子弟，喜欢串戏	第四十七回
赖尚荣	荣国府大管家赖大之子，县官	第四十七回
邢岫烟	邢夫人的侄女，薛蝌之妻	第四十九回
邢忠	邢夫人之兄，邢岫烟之父	第四十九回
李婶娘	李纨的婶娘	第四十九回
李纹	李婶娘之女	第四十九回
李绮	李纨娘之女	第四十九回
梅翰林		第四十九回
胡君荣	即“胡庸医”御医	第五十一回
良儿		第五十二回
乌进孝	宁国府黑山庄庄头	第五十三回
娄氏	贾菌之母	第五十三回
女先儿	说书的女艺人	第五十四回
单大良		第五十四回
赵国基	赵姨娘的兄弟	第五十五回
单大娘	单大良之妻，也称单大良家的	第五十六回
祝妈	管理大观园竹林的佣人	第五十六回
田妈	管理大观园谷物庄稼的佣人	第五十六回
叶妈	茗烟的母亲，大观园花草的佣人，莺儿的干娘	第五十六回
许氏	贾蓉的续弦妻子	第五十八回
何婆子	丫鬟春燕之母，芳官的干娘，贾府佣人	第五十九回
小鸠儿	何婆的女儿，春燕的妹妹	第五十九回
夏婆子	也称作“夏妈”，春燕的姨妈，藕官的干娘	第六十回
柳家的	贾府做饭的佣人，五儿之母，也称“柳妈”或“柳嫂子”	第六十回
柳五儿	柳嫂子之女	第六十回
秦显家的	司棋的婶娘，荣国府上夜的佣人	第六十一回
佩凤	贾珍之妾	第六十三回
偕鸾	贾珍之妾	第六十三回
尤二姐	尤氏的妹妹	第六十三回
尤三姐	尤二姐的妹妹	第六十三回
尤老娘	尤氏的继母，尤二姐、尤三姐的母亲	第六十三回	在六十八回中，凤姐提到她最近死了
张华	皇粮庄的庄头之后	第六十四回
俞禄	宁国府的小管家	第六十四回
秋桐	原来为贾赦的丫鬟，后赏给贾琏做妾	第六十九回
天文生	阴阳先生	第六十九回
潘又安	司棋的姑表弟	第七十一回
朱大娘	官媒婆	第七十二回
周太监		第七十二回
小霞	丫鬟彩霞的妹妹	第七十二回
翠云	贾赦的侍妾	第七十四回
来喜家的	王夫人的陪房	第七十四回
王善保家的	邢夫人的陪房，司棋的外祖母	第七十四回
张妈	看后门的佣人	第七十四回
邢德全	人称“傻大舅”，邢夫人的胞弟	第七十五回
文花	贾珍之妾	第七十五回
圆信	也作“圆心”，地藏庵尼姑	第七十七回
智通	水月庵尼姑	第七十七回
孙绍祖	贾府世交之后，贾迎春之夫	第七十九回
夏金桂	薛蟠之妻	第七十九回
夏奶奶	夏金桂之母	第七十九回
王一贴	天齐庙的道士	第八十回
